SEZIONE,FRANCESCO LADDAGA,LUIGI AVVEDUTO,TOTALE,AFFLUENZA,MUNICIPIO
844,238,207,445,0.4250238777459408,7
848,243,137,380,0.29275808936825887,7
854,301,163,464,0.5093304061470911,7
855,258,138,396,0.6055045871559633,7
857,268,104,372,0.5821596244131455,7
858,235,125,360,0.6545454545454545,7
859,331,196,527,0.7550143266475645,7
860,217,80,297,0.27297794117647056,7
861,293,125,418,0.48717948717948717,7
862,282,183,465,0.7187017001545595,7
863,280,112,392,0.4542294322132097,7
864,289,132,421,0.511543134872418,7
865,316,163,479,0.5042105263157894,7
866,316,126,442,0.5151515151515151,7
867,224,88,312,0.5098039215686274,7
868,271,117,388,0.5012919896640827,7
869,332,101,433,0.5399002493765586,7
870,218,101,319,0.4725925925925926,7
871,226,122,348,0.5014409221902018,7
872,182,124,306,0.46153846153846156,7
873,355,227,582,0.5521821631878557,7
874,211,123,334,0.5276461295418642,7
875,245,148,393,0.4486301369863014,7
876,266,150,416,0.47380410022779046,7
877,316,176,492,0.5051334702258727,7
878,290,134,424,0.43621399176954734,7
879,242,137,379,0.4571773220747889,7
880,289,134,423,0.49473684210526314,7
881,175,69,244,0.4326241134751773,7
882,177,110,287,0.47833333333333333,7
883,246,130,376,0.46134969325153374,7
884,228,103,331,0.4681753889674682,7
885,201,106,307,0.5057660626029654,7
886,303,171,474,0.5486111111111112,7
887,264,135,399,0.5006273525721455,7
888,233,133,366,0.5041322314049587,7
889,217,110,327,0.42084942084942084,7
890,282,150,432,0.5192307692307693,7
891,283,156,439,0.5571065989847716,7
892,195,123,318,0.5039619651347068,7
893,193,126,319,0.5071542130365659,7
894,237,145,382,0.5418439716312057,7
895,250,126,376,0.5740458015267176,7
896,247,120,367,0.5265423242467718,7
897,189,123,312,0.4406779661016949,7
898,212,108,320,0.48265460030165913,7
899,181,99,280,0.44025157232704404,7
900,219,89,308,0.46107784431137727,7
901,218,130,348,0.4233576642335766,7
902,231,113,344,0.49072753209700426,7
903,251,93,344,0.441591784338896,7
904,236,129,365,0.4620253164556962,7
905,187,83,270,0.4433497536945813,7
906,269,106,375,0.47468354430379744,7
907,154,92,246,0.47766990291262135,7
908,295,122,417,0.4911660777385159,7
909,224,108,332,0.5045592705167173,7
910,196,143,339,0.4478203434610304,7
911,246,113,359,0.469281045751634,7
912,261,163,424,0.49765258215962443,7
913,200,110,310,0.512396694214876,7
914,200,132,332,0.4992481203007519,7
915,287,169,456,0.5072302558398221,7
916,200,123,323,0.46275071633237824,7
917,279,128,407,0.43023255813953487,7
918,129,89,218,0.34222919937205654,7
919,195,162,357,0.32933579335793356,7
931,158,125,283,0.4492063492063492,7
941,163,117,280,0.4236006051437216,7
942,227,151,378,0.4666666666666667,7
943,197,148,345,0.42021924482338613,7
944,167,119,286,0.49310344827586206,7
945,170,109,279,0.38966480446927376,7
946,228,187,415,0.46162402669632924,7
947,252,148,400,0.43149946062567424,7
948,273,183,456,0.5170068027210885,7
950,208,146,354,0.4498094027954257,7
951,190,121,311,0.4049479166666667,7
952,241,163,404,0.4758539458186101,7
953,173,88,261,0.4003067484662577,7
954,258,149,407,0.47380675203725264,7
955,232,123,355,0.44766708701134933,7
956,312,131,443,0.4758324382384533,7
957,203,107,310,0.4189189189189189,7
958,199,82,281,0.4048991354466859,7
959,296,122,418,0.47446083995459704,7
960,248,107,355,0.4658792650918635,7
961,246,71,317,0.4058898847631242,7
962,415,174,589,0.5925553319919518,7
963,244,104,348,0.5312977099236641,7
964,239,93,332,0.4585635359116022,7
965,224,119,343,0.5029325513196481,7
966,320,174,494,0.5329018338727076,7
967,227,85,312,0.5106382978723404,7
968,327,117,444,0.5311004784688995,7
969,378,100,478,0.5610328638497653,7
970,299,135,434,0.5585585585585585,7
971,220,138,358,0.5319465081723626,7
972,341,145,486,0.5225806451612903,7
973,284,112,396,0.4987405541561713,7
974,116,258,374,0.4588957055214724,7
975,318,123,441,0.494949494949495,7
976,181,104,285,0.3963838664812239,7
977,339,123,462,0.5162011173184358,7
978,274,125,399,0.525,7
979,290,78,368,0.4842105263157895,7
980,232,132,364,0.4702842377260982,7
981,258,120,378,0.5308988764044944,7
982,287,118,405,0.5321944809461235,7
983,255,147,402,0.5180412371134021,7
984,193,98,291,0.46634615384615385,7
985,304,112,416,0.5265822784810127,7
986,249,125,374,0.4645962732919255,7
987,163,92,255,0.4300168634064081,7
988,308,161,469,0.5165198237885462,7
989,233,115,348,0.45194805194805193,7
990,247,89,336,0.4905109489051095,7
991,255,109,364,0.44938271604938274,7
992,258,113,371,0.479328165374677,7
993,240,110,350,0.5007153075822603,7
994,233,79,312,0.5435540069686411,7
995,285,160,445,0.5126728110599078,7
996,286,131,417,0.546526867627785,7
997,334,101,435,0.5190930787589498,7
998,305,137,442,0.5045662100456622,7
999,239,98,337,0.4985207100591716,7
1000,230,73,303,0.5126903553299492,7
1001,211,71,282,0.501779359430605,7
1002,301,160,461,0.5705445544554455,7
1003,300,136,436,0.5034642032332564,7
1004,317,152,469,0.5719512195121951,7
1005,219,103,322,0.5168539325842697,7
1006,242,86,328,0.5568760611205433,7
1007,277,131,408,0.5666666666666667,7
1008,348,128,476,0.44863336475023563,7
1010,369,191,560,0.5100182149362478,7
1012,317,215,532,0.49953051643192486,7
1013,326,194,520,0.46973803071364045,7
1014,215,92,307,0.5142378559463987,7
1015,169,107,276,0.47586206896551725,7
1016,143,69,212,0.507177033492823,7
1017,264,169,433,0.5118203309692672,7
1018,247,141,388,0.5012919896640827,7
1019,246,150,396,0.474251497005988,7
1020,202,157,359,0.42840095465393796,7
1021,253,132,385,0.5563583815028902,7
1022,315,119,434,0.5695538057742782,7
1024,234,149,383,0.42041712403951703,7
1025,209,136,345,0.4328732747804266,7
1026,128,86,214,0.38838475499092556,7
1027,265,98,363,0.4384057971014493,7
1028,141,101,242,0.34375,7
1029,180,117,297,0.36666666666666664,7
1030,169,100,269,0.3225419664268585,7
1031,234,40,274,0.3325242718446602,7
1032,151,82,233,0.3157181571815718,7
1033,170,101,271,0.35894039735099337,7
1034,154,96,250,0.37537537537537535,7
1035,146,92,238,0.3801916932907348,7
1036,167,82,249,0.3557142857142857,7
1037,204,76,280,0.38620689655172413,7
1038,168,101,269,0.3654891304347826,7
1039,124,72,196,0.3141025641025641,7
1040,198,116,314,0.3742550655542312,7
1041,178,112,290,0.4309063893016345,7
1043,179,83,262,0.3981762917933131,7
1044,152,96,248,0.33649932157394846,7
1045,159,94,253,0.34705075445816186,7
1046,154,88,242,0.38351822503961963,7
1047,165,93,258,0.3932926829268293,7
1048,142,108,250,0.36075036075036077,7
1049,184,102,286,0.4393241167434716,7
1050,201,105,306,0.4935483870967742,7
1051,160,111,271,0.4342948717948718,7
1052,195,99,294,0.4362017804154303,7
1053,156,106,262,0.3700564971751412,7
1054,185,133,318,0.4076923076923077,7
1055,182,131,313,0.4007682458386684,7
1056,186,108,294,0.3466981132075472,7
1057,132,76,208,0.4306418219461698,7
1058,269,137,406,0.4816132858837485,7
1060,273,121,394,0.43973214285714285,7
1061,168,133,301,0.38939197930142305,7
1062,177,105,282,0.3337278106508876,7
1063,211,116,327,0.40977443609022557,7
1064,262,119,381,0.49609375,7
1065,242,103,345,0.46433378196500674,7
1066,283,171,454,0.5089686098654709,7
1067,256,110,366,0.480946123521682,7
1068,144,79,223,0.46265560165975106,7
1069,180,98,278,0.44126984126984126,7
1070,69,82,151,0.2903846153846154,7
1071,200,141,341,0.41183574879227053,7
1072,304,140,444,0.5144843568945539,7
1073,77,63,140,0.25594149908592323,7
1076,252,161,413,0.4375,7
1077,290,144,434,0.4827586206896552,7
1078,189,107,296,0.46984126984126984,7
1079,197,118,315,0.3977272727272727,7
1080,169,110,279,0.3595360824742268,7
1081,147,99,246,0.44324324324324327,7
1082,210,123,333,0.5123076923076924,7
1083,179,88,267,0.37980085348506404,7
1084,91,102,193,0.2859259259259259,7
1085,174,140,314,0.4120734908136483,7
1086,126,124,250,0.43327556325823224,7
1087,205,145,350,0.44136191677175285,7
1088,140,119,259,0.3781021897810219,7
1089,104,117,221,0.32985074626865674,7
1091,194,105,299,0.45718654434250766,7
1092,180,106,286,0.44617784711388453,7
1093,249,116,365,0.5383480825958702,7
1094,256,117,373,0.4953519256308101,7
1095,330,116,446,0.4759871931696905,7
1096,254,141,395,0.4535017221584386,7
1097,225,96,321,0.48710166919575115,7
1098,273,147,420,0.519159456118665,7
1099,250,135,385,0.5317679558011049,7
1100,309,143,452,0.48549946294307195,7
1101,163,114,277,0.4851138353765324,7
1102,303,109,412,0.44929116684841874,7
1103,289,157,446,0.5540372670807453,7
1104,299,161,460,0.5330243337195828,7
1105,300,130,430,0.5218446601941747,7
1106,210,108,318,0.4690265486725664,7
1107,248,133,381,0.48166877370417194,7
1108,198,102,300,0.4702194357366771,7
1109,231,91,322,0.5218800648298217,7
1110,258,158,416,0.4988009592326139,7
1111,228,112,340,0.49926578560939794,7
1112,300,216,516,0.5124131082423039,7
1113,207,163,370,0.49731182795698925,7
1114,246,154,400,0.43478260869565216,7
1115,241,92,333,0.3872093023255814,7
1116,216,122,338,0.4794326241134752,7
1117,268,99,367,0.49527665317139,7
1118,191,132,323,0.39246658566221143,7
1119,236,137,373,0.5088676671214188,7
1120,157,112,269,0.4075757575757576,7
1121,227,108,335,0.5491803278688525,7
1122,141,98,239,0.4742063492063492,7
1123,244,159,403,0.49146341463414633,7
1124,247,167,414,0.4830805134189031,7
1125,253,163,416,0.4388185654008439,7
1126,191,183,374,0.4202247191011236,7
1136,257,169,426,0.4329268292682927,7
1137,242,168,410,0.46223224351747466,7
1138,258,167,425,0.4579741379310345,7
1139,219,100,319,0.47050147492625366,7
1140,172,112,284,0.38430311231393777,7
1141,225,117,342,0.44129032258064516,7
1142,158,108,266,0.36944444444444446,7
1143,218,135,353,0.4508301404853129,7
1144,267,160,427,0.4728682170542636,7
1145,195,107,302,0.5373665480427047,7
1146,187,98,285,0.4391371340523883,7
1147,155,114,269,0.4381107491856677,7
1148,259,128,387,0.4690909090909091,7
1149,168,96,264,0.40993788819875776,7
1150,254,102,356,0.4203069657615112,7
1151,222,119,341,0.41585365853658535,7
1152,295,191,486,0.4438356164383562,7
1153,264,186,450,0.389948006932409,7
1154,148,135,283,0.3389221556886228,7
1155,167,196,363,0.3129310344827586,7
1156,190,215,405,0.3886756238003839,7
1157,178,122,300,0.3618817852834741,7
1158,264,165,429,0.4054820415879017,7
1159,229,185,414,0.476409666283084,7
1160,263,193,456,0.3784232365145228,7
1161,244,239,483,0.4052013422818792,7
1162,298,162,460,0.3868797308662742,7
1163,163,101,264,0.36213991769547327,7
1164,275,138,413,0.47856315179606024,7
1165,214,159,373,0.38335046248715315,7
1166,205,214,419,0.39158878504672895,7
1167,199,131,330,0.4225352112676056,7
1168,244,175,419,0.39195509822263797,7
1169,205,205,410,0.4320337197049526,7
1170,228,162,390,0.4083769633507853,7
1171,202,156,358,0.3729166666666667,7
1172,223,169,392,0.4139387539598733,7
1173,205,177,382,0.38742393509127787,7
1174,193,134,327,0.3678290213723285,7
1175,188,131,319,0.43342391304347827,7
1176,163,129,292,0.48344370860927155,7
1177,204,182,386,0.4132762312633833,7
1178,191,117,308,0.3688622754491018,7
1179,184,106,290,0.38821954484605087,7
1180,195,130,325,0.4298941798941799,7
1181,149,111,260,0.48598130841121495,7
1182,178,100,278,0.4784853700516351,7
1183,185,138,323,0.4430727023319616,7
1184,169,153,322,0.4214659685863874,7
1185,246,189,435,0.47540983606557374,7
1186,169,142,311,0.33085106382978724,7
1187,195,187,382,0.3843058350100604,7
1188,186,187,373,0.3653281096963761,7
1189,175,132,307,0.31135902636916835,7
1190,198,170,368,0.3455399061032864,7
