SEZIONE,ANDREA SIGNORINI,DANIELE TORQUATI,TOTALE,AFFLUENZA,MUNICIPIO
577,221,183,404,0.7739463601532567,15
2214,139,153,292,0.43004418262150224,15
2215,158,167,325,0.4931714719271624,15
2216,154,166,320,0.460431654676259,15
2217,159,177,336,0.5316455696202531,15
2218,122,263,385,0.5317679558011049,15
2219,184,247,431,0.5619295958279009,15
2220,124,148,272,0.40536512667660207,15
2221,123,180,303,0.4563253012048193,15
2222,118,164,282,0.48704663212435234,15
2223,78,202,280,0.47217537942664417,15
2224,170,151,321,0.5039246467817896,15
2225,130,132,262,0.3957703927492447,15
2226,266,224,490,0.5493273542600897,15
2227,216,222,438,0.4850498338870432,15
2228,246,219,465,0.48037190082644626,15
2229,186,219,405,0.49210206561360875,15
2230,186,149,335,0.46787709497206703,15
2231,128,149,277,0.4902654867256637,15
2232,229,159,388,0.5647743813682679,15
2233,203,180,383,0.5724962630792227,15
2234,200,225,425,0.573549257759784,15
2235,188,226,414,0.5872340425531914,15
2237,186,207,393,0.5420689655172414,15
2238,158,150,308,0.501628664495114,15
2239,212,219,431,0.5199034981905911,15
2240,211,251,462,0.5133333333333333,15
2241,248,166,414,0.48994082840236686,15
2242,177,244,421,0.5229813664596273,15
2243,206,184,390,0.4875,15
2244,306,196,502,0.5691609977324263,15
2245,175,231,406,0.45464725643896975,15
2336,215,199,414,0.516209476309227,15
2337,176,226,402,0.4956843403205919,15
2338,160,208,368,0.4880636604774536,15
2339,196,235,431,0.5532734274711169,15
2353,223,140,363,0.48079470198675495,15
2359,218,281,499,0.4960238568588469,15
2360,266,210,476,0.5010526315789474,15
2361,253,245,498,0.4619666048237477,15
2362,239,223,462,0.4633901705115346,15
2363,273,251,524,0.4666073018699911,15
2364,231,213,444,0.4396039603960396,15
2365,247,261,508,0.49706457925636005,15
2404,87,81,168,0.3870967741935484,15
2405,125,130,255,0.4194078947368421,15
2406,255,155,410,0.40473840078973344,15
2407,213,227,440,0.4309500489715965,15
2408,163,127,290,0.3656998738965952,15
2409,224,193,417,0.4116485686080948,15
2410,198,123,321,0.41101152368758004,15
2411,199,172,371,0.4608695652173913,15
2412,197,184,381,0.40748663101604277,15
2413,67,91,158,0.398989898989899,15
2414,170,146,316,0.3945068664169788,15
2415,245,181,426,0.4541577825159915,15
2416,177,176,353,0.5405819295558959,15
2417,231,229,460,0.46795523906408953,15
2418,219,200,419,0.4619625137816979,15
2419,242,194,436,0.44263959390862945,15
2420,208,140,348,0.38453038674033146,15
2421,175,187,362,0.4670967741935484,15
2422,147,172,319,0.3918918918918919,15
2423,230,149,379,0.3786213786213786,15
2424,125,166,291,0.4110169491525424,15
2425,135,189,324,0.39657282741738065,15
2426,120,142,262,0.3695345557122708,15
2434,163,140,303,0.49917627677100496,15
2435,126,183,309,0.5167224080267558,15
2436,90,141,231,0.4647887323943662,15
2437,135,234,369,0.5650842266462481,15
2438,121,177,298,0.47527910685805425,15
2439,105,159,264,0.4018264840182648,15
2440,86,179,265,0.45768566493955093,15
2441,114,163,277,0.4128166915052161,15
2442,144,128,272,0.4114977307110439,15
2443,115,156,271,0.42812006319115326,15
2444,93,134,227,0.44597249508840864,15
2445,100,100,200,0.36036036036036034,15
2446,103,89,192,0.3794466403162055,15
2447,77,158,235,0.4072790294627383,15
2448,93,147,240,0.4355716878402904,15
2449,93,110,203,0.4194214876033058,15
2450,139,148,287,0.3873144399460189,15
2451,140,207,347,0.46328437917222964,15
2452,136,184,320,0.4698972099853157,15
2453,102,149,251,0.458029197080292,15
2454,115,175,290,0.506108202443281,15
2455,162,184,346,0.4292803970223325,15
2456,92,114,206,0.46924829157175396,15
2457,133,141,274,0.5209125475285171,15
2458,111,198,309,0.5273037542662116,15
2459,111,154,265,0.4274193548387097,15
2460,118,203,321,0.4115384615384615,15
2461,146,144,290,0.4923599320882852,15
2462,150,206,356,0.5035360678925035,15
2463,117,174,291,0.5087412587412588,15
2464,170,207,377,0.5511695906432749,15
2465,173,181,354,0.5,15
2466,171,226,397,0.4521640091116173,15
2467,113,112,225,0.4174397031539889,15
2468,178,180,358,0.48707482993197276,15
2469,158,156,314,0.5155993431855501,15
2470,271,259,530,0.5145631067961165,15
2471,153,160,313,0.3937106918238994,15
2472,229,190,419,0.4486081370449679,15
2473,174,193,367,0.46163522012578617,15
2474,204,247,451,0.45235707121364094,15
2475,172,161,333,0.44047619047619047,15
2476,212,204,416,0.39884947267497606,15
2477,198,198,396,0.41596638655462187,15
2478,290,248,538,0.5089877010406811,15
2479,102,117,219,0.3802083333333333,15
2480,111,107,218,0.3844797178130511,15
2481,134,282,416,0.5219573400250941,15
2482,132,164,296,0.3704630788485607,15
2483,117,194,311,0.3877805486284289,15
2484,124,171,295,0.3949129852744311,15
2485,129,187,316,0.43169398907103823,15
2486,101,130,231,0.4520547945205479,15
2487,161,217,378,0.4638036809815951,15
2488,76,66,142,0.2526690391459075,15
2489,149,193,342,0.48169014084507045,15
2490,126,169,295,0.4331864904552129,15
2491,129,139,268,0.3732590529247911,15
2492,116,170,286,0.43007518796992483,15
2493,113,185,298,0.463452566096423,15
2494,73,37,110,0.25882352941176473,15
2495,97,72,169,0.26996805111821087,15
2496,92,88,180,0.31802120141342755,15
2497,138,91,229,0.38617200674536256,15
2498,223,196,419,0.4387434554973822,15
2499,189,124,313,0.37041420118343193,15
2500,166,152,318,0.38405797101449274,15
2501,130,100,230,0.4144144144144144,15
2502,151,119,270,0.4292527821939587,15
2503,136,136,272,0.41590214067278286,15
2504,213,152,365,0.3014037985136251,15
2505,204,111,315,0.24324324324324326,15
2506,207,169,376,0.3233018056749785,15
2507,245,146,391,0.3350471293916024,15
2508,180,199,379,0.3429864253393665,15
2509,211,243,454,0.40535714285714286,15
2598,6,7,13,,15
2600,3,5,8,,15
